110210
113131
111011
111111
101101
141411
111011
111011
000011