111000
113211
030111
111111
111010
110411
010411
111111
111011