210411
114411
110011
111311
113311
111011
000110
000110